7
0 2 6 0 0 0 0
2 0 0 5 0 0 0
6 0 0 8 0 0 0
0 5 8 0 10 15 0
0 0 0 10 0 6 2
0 0 0 0 6 0 6
0 0 0 0 2 6 0

9
0 4 0 0 0  0 0 8 0
4 0 8 0 0 0 0 11 0
0 8 0 7 0 4 0 0 2
0 0 7 0 9 14 0 0 0
0 0 0 9 0 10 0 0 0
0 0 4 14 10 0 2 0 0
0 0 0 0 0 2 0 1 6
8 11 0 0 0 0 1 0 7
0 0 2 0 0 0 6 7 0