7
0 2 6 0 0 0 0
2 0 0 5 0 0 0
6 0 0 8 0 0 0
0 5 8 0 10 15 0
0 0 0 10 0 6 2
0 0 0 0 6 0 6
0 0 0 0 2 6 0